#
# Comments begin with '#' and are ignored when reading in the map
# 'x' stands for the automatically spawned border of unbreakable walls
# 'CC' stands for the center of each border
# 'U' stands for unbreakable walls
# 'B' stands for breakable walls
# 'S' stand for spawn point
# ' ' stands for blank space
#
xxxxxxxxxxxxxxxxxxxxxxxxxxxxxxxxxxxxxxxxxxxxxxxxCCxxxxxxxxxxxxxxxxxxxxxxxxxxxxxxxxxxxxxxxxxxxxxxxx
x                   BBBBBBBB                                         BBBBBBBB                    x
x    S              BBBBBBBB                                         BBBBBBBB               S    x
x                   BBBBBBBB                                         BBBBBBBB                    x
x                   BBBBBBBB                                         BBBBBBBB                    x
x            BBBBBBBBBBBBBBB                                         BBBBBBBBBBBBBBBB            x
x            BBBBBBBBBBBBBBB                                         BBBBBBBBBBBBBBBB            x
x            BBBBBBBBBBBBBBB                                         BBBBBBBBBBBBBBBB            x
xBBBBBBBBBBBBBBBBBBBBBBBBBBB                                         BBBBBBBBBBBBBBBBBBBBBBBBBBBBx
xBBBBBBBBBBBBBBBBBBBBBBBBBBB                                         BBBBBBBBBBBBBBBBBBBBBBBBBBBBx
xBBBBBBBBBBBBBBBBBBBUUUUUUUU                                         UUUUUUUUBBBBBBBBBBBBBBBBBBBBx
x                   UUUUUUUU                                         UUUUUUUU                    x
x                   UUUUUUUU                                         UUUUUUUU                    x
x                   UUUUUUUU                                         UUUUUUUU                    x
x                   BBBBBBBBBBBBB                               BBBBBBBBBBBBB                    x
x                   BBBBBBBBBBBBB            UU    UU           BBBBBBBBBBBBB                    x
x                   BBBBBBBBBBBBB         UUUUU    UUUUU        BBBBBBBBBBBBB                    x
x                   BBBBBBBBBBBBB         UUUUU    UUUUU        BBBBBBBBBBBBB                    x
xBBBBBBBB           BBBBBBBBBBBBB            UU    UU           BBBBBBBBBBBBB            BBBBBBBBx
CBBBBBBBB           BBBBBBBBBBBBB               S               BBBBBBBBBBBBB            BBBBBBBBC
CBBBBBBBB           BBBBBBBBBBBBB                               BBBBBBBBBBBBB            BBBBBBBBC
xBBBBBBBB           BBBBBBBBBBBBB            UU    UU           BBBBBBBBBBBBB            BBBBBBBBx
x                   BBBBBBBBBBBBB         UUUUU    UUUUU        BBBBBBBBBBBBB                    x
x                   BBBBBBBBBBBBB         UUUUU    UUUUU        BBBBBBBBBBBBB                    x
x                   BBBBBBBBBBBBB            UU    UU           BBBBBBBBBBBBB                    x
x                   BBBBBBBBBBBBB                               BBBBBBBBBBBBB                    x
x                   UUUUUUUU                                         UUUUUUUU                    x
x                   UUUUUUUU                                         UUUUUUUU                    x
x                   UUUUUUUU                                         UUUUUUUU                    x
xBBBBBBBBBBBBBBBBBBBUUUUUUUU                                         UUUUUUUUBBBBBBBBBBBBBBBBBBBBx
xBBBBBBBBBBBBBBBBBBBBBBBBBBB                                         BBBBBBBBBBBBBBBBBBBBBBBBBBBBx
xBBBBBBBBBBBBBBBBBBBBBBBBBBB                                         BBBBBBBBBBBBBBBBBBBBBBBBBBBBx
x            BBBBBBBBBBBBBBB                                         BBBBBBBBBBBBBBBB            x
x            BBBBBBBBBBBBBBB                                         BBBBBBBBBBBBBBBB            x
x            BBBBBBBBBBBBBBB                                         BBBBBBBBBBBBBBBB            x
x                   BBBBBBBB                                         BBBBBBBB                    x
x                   BBBBBBBB                                         BBBBBBBB                    x
x    S              BBBBBBBB                                         BBBBBBBB               S    x
x                   BBBBBBBB                                         BBBBBBBB                    x
xxxxxxxxxxxxxxxxxxxxxxxxxxxxxxxxxxxxxxxxxxxxxxxxCCxxxxxxxxxxxxxxxxxxxxxxxxxxxxxxxxxxxxxxxxxxxxxxxx