#
# Comments begin with '#' and are ignored when reading in the map
# 'x' stands for the automatically spawned border of unbreakable walls
# 'CC' stands for the center of each border
# 'U' stands for unbreakable walls
# 'B' stands for breakable walls
# 'S' stand for spawn point
# ' ' stands for blank space
#
xxxxxxxxxxxxxxxxxxxxxxxxxxxxxxxxxxxxxxxxxxxxxxxxCCxxxxxxxxxxxxxxxxxxxxxxxxxxxxxxxxxxxxxxxxxxxxxxxx
x    UUUUUUUUUUUUUUUUUUUUUUUUUUUUUUUUUUUUUUUUUUUUUUUUUUUUUUUUUUUU          UUUUUUUUUUUUUUUUUUUU  x
x    UUUUUUUUUUUUUUUUUUUUUUUUUUUUUUUUUUUUUUUUUUUUUUUUUUUUUUUUUUUU          UUUUUUUUUUUUUUUUUUUU  x
x    UUUUUUUUUUUUUUUUUUUUUUUUUUUUUUUUUUUUUUUUUUUUUUUUUUUUUUUUUUUU          UUUUUUUUUUUUUUUUUUUU  x
x                         BBBB                                                                   x
x                         BBBB                                                                   x
xBBUUUUUUUUUUUUUUUUUUUU   BBBB   UUUUUUUUUUUUUUUUUUUUUUUUUUUUUUUUUUUUUUUUUUUUUUUUUUUUUUUUUUUU    x
xBBUUUUUUUUUUUUUUUUUUUUBBBBBBBBBBUUUUUUUUUUUUUUUUUUUUUUUUUUUUUUUUUUUUUUUUUUUUUUUUUUUUUUUUUUUU    x
xBBUUUUUUUUUUUUUUUUUUUUBBBBBBBBBBUUUUUUUUUUUUUUUUUUUUUUUUUUUUUUUUUUUUUUUUUUUUUUUUUUUUUUUUUUUU    x
xBBUUUUUUUUUUUUUUUUUUUU   BBBB   UUUUUUUUUUUUUUUUUUUUUUUUUUUUUUUUUUUUUUUUUUUUUUUUUUUUUUUUUUUU    x
x                         BBBB                  S                   BBBB                         x
x                         BBBB                                      BBBB                         x
x    UUUUUUUUUUUUUUUUUUUUUUUUUUUUUUUUUUUUUUUUUUUUUUUUUUUUUUUUUUUU   BBBB   UUUUUUUUUUUUUUUUUUUUBBx
x    UUUUUUUUUUUUUUUUUUUUUUUUUUUUUUUUUUUUUUUUUUUUUUUUUUUUUUUUUUUUBBBBBBBBBBUUUUUUUUUUUUUUUUUUUUBBx
x    UUUUUUUUUUUUUUUUUUUUUUUUUUUUUUUUUUUUUUUUUUUUUUUUUUUUUUUUUUUUBBBBBBBBBBUUUUUUUUUUUUUUUUUUUUBBx
x    UUUUUUUUUUUUUUUUUUUUUUUUUUUUUUUUUUUUUUUUUUUUUUUUUUUUUUUUUUUU   BBBB   UUUUUUUUUUUUUUUUUUUUBBx
x                        S                      BB        S         BBBB                         x
x                                               BB                  BBBB                         x
x    UUUUUUUUUUUUUUUUUUUUUUUUUUUUUUUUUUUUUUUU   BB   UUUUUUUUUUUUUUUUUUUUUUUUUUUUUUUUUUUUUUUU    x
CBBBBUUUUUUUUUUUUUUUUUUUUUUUUUUUUUUUUUUUUUUUUBBBBBBBBUUUUUUUUUUUUUUUUUUUUUUUUUUUUUUUUUUUUUUUU    C
CBBBBUUUUUUUUUUUUUUUUUUUUUUUUUUUUUUUUUUUUUUUUBBBBBBBBUUUUUUUUUUUUUUUUUUUUUUUUUUUUUUUUUUUUUUUU    C
x    UUUUUUUUUUUUUUUUUUUUUUUUUUUUUUUUUUUUUUUU   BB   UUUUUUUUUUUUUUUUUUUUUUUUUUUUUUUUUUUUUUUU    x
x                         BBBB        S         BB                      S                        x
x                         BBBB                  BB                                               x
xBBUUUUUUUUUUUUUUUUUUUU   BBBB   UUUUUUUUUUUUUUUUUUUUUUUUUUUUUUUUUUUUUUUUUUUUUUUUUUUUUUUUUUUU    x
xBBUUUUUUUUUUUUUUUUUUUUBBBBBBBBBBUUUUUUUUUUUUUUUUUUUUUUUUUUUUUUUUUUUUUUUUUUUUUUUUUUUUUUUUUUUUBBBBx
xBBUUUUUUUUUUUUUUUUUUUUBBBBBBBBBBBUUUUUUUUUUUUUUUUUUUUUUUUUUUUUUUUUUUUUUUUUUUUUUUUUUUUUUUUUUUBBBBx
xBBUUUUUUUUUUUUUUUUUUUU   BBBB   UUUUUUUUUUUUUUUUUUUUUUUUUUUUUUUUUUUUUUUUUUUUUUUUUUUUUUUUUUUU    x
x                         BBBB                  S                   BBBB                         x
x                         BBBB                                      BBBB                         x
x    UUUUUUUUUUUUUUUUUUUUUUUUUUUUUUUUUUUUUUUUUUUUUUUUUUUUUUUUUUUU   BBBB   UUUUUUUUUUUUUUUUUUUUBBx
x    UUUUUUUUUUUUUUUUUUUUUUUUUUUUUUUUUUUUUUUUUUUUUUUUUUUUUUUUUUUUBBBBBBBBBBUUUUUUUUUUUUUUUUUUUUBBx
x    UUUUUUUUUUUUUUUUUUUUUUUUUUUUUUUUUUUUUUUUUUUUUUUUUUUUUUUUUUUUBBBBBBBBBBUUUUUUUUUUUUUUUUUUUUBBx
x    UUUUUUUUUUUUUUUUUUUUUUUUUUUUUUUUUUUUUUUUUUUUUUUUUUUUUUUUUUUU   BBBB   UUUUUUUUUUUUUUUUUUUUBBx
x                                                                   BBBB                         x
x                                                                   BBBB                         x
x  UUUUUUUUUUUUUUUUUUUU          UUUUUUUUUUUUUUUUUUUUUUUUUUUUUUUUUUUUUUUUUUUUUUUUUUUUUUUUUUUU    x
x  UUUUUUUUUUUUUUUUUUUU          UUUUUUUUUUUUUUUUUUUUUUUUUUUUUUUUUUUUUUUUUUUUUUUUUUUUUUUUUUUU    x
x  UUUUUUUUUUUUUUUUUUUU          UUUUUUUUUUUUUUUUUUUUUUUUUUUUUUUUUUUUUUUUUUUUUUUUUUUUUUUUUUUU    x
xxxxxxxxxxxxxxxxxxxxxxxxxxxxxxxxxxxxxxxxxxxxxxxxCCxxxxxxxxxxxxxxxxxxxxxxxxxxxxxxxxxxxxxxxxxxxxxxxx